KRT = "countries/Kartli.txt"
MGL = "countries/Nmongolia.txt"
GTH = "countries/Gothia.txt"
TRN = "countries/Turan.txt"
AME = "countries/Armenianempire.txt"
SRK = "countries/Sarukhanids.txt"
CMN = "countries/Cumania.txt"
AEG = "countries/Aegyptos.txt"
ATG = "countries/Anushteginids.txt"
ZNG = "countries/Zangids.txt"
AKG = "countries/Akgunids.txt"
HLE = "countries/Hellenicempire.txt"
AKR = "countries/Aksaray.txt"
TKK = "countries/Teke.txt"
ALN = "countries/Alania.txt"
CLC = "countries/Cilicia.txt"
SEL = "countries/Seljuks.txt"
XUN = "countries/Xuanzheng.txt"
KUS = "countries/Kushans.txt"
JOO = "countries/Jomon.txt"
ROC = "countries/China.txt"
JPE = "countries/Japaneseempire.txt"
BSS = "countries/Bessho.txt"
UKM = "countries/Urakami.txt"
AWG = "countries/Awaga.txt"
MGM = "countries/Mogami.txt"
NGO = "countries/Nagao.txt"
KMK = "countries/Kamakura.txt"
NKT = "countries/Nakata.txt"
HTA = "countries/Hata.txt"
UWA = "countries/Uwa.txt"
MRT = "countries/Morokata.txt"
KWH = "countries/Kuwahara.txt"
OIT = "countries/Oita.txt"
UDO = "countries/Udo.txt"
ZHH = "countries/Zhou.txt"
LGG = "countries/Liangtsang.txt"
AMD = "countries/Amdo.txt"
GNJ = "countries/Gonjo.txt"
SKY = "countries/Sakya.txt"
XXI = "countries/Xia.txt"
TJJ = "countries/Toyouji.txt"
EKK = "countries/Evenkia.txt"
GGR = "countries/Goguryeo.txt"
TGU = "countries/Li.txt"
CRS = "countries/Choros.txt"
DRB = "countries/Dorbet.txt"
KHT = "countries/Khoid.txt"
TRG = "countries/Torghut.txt"
SNG = "countries/Song.txt"
HNN = "countries/Han.txt"
NLL = "countries/Ula.txt"
ASG = "countries/Aisin.txt"
ODL = "countries/Odoli.txt"
TMG = "countries/Temugids.txt"
JSN = "countries/Joseon.txt"
GOR = "countries/Goryeo.txt"
LIO = "countries/Liao.txt"
KRR = "countries/Kroraina.txt"
KUC = "countries/Kuci.txt"
SLH = "countries/Shule.txt"
TCR = "countries/Tocharia.txt"
QQT = "countries/Khitai.txt"
FII = "countries/Frisia.txt"
BLS = "countries/Balansiyah.txt"
EFC = "countries/Eastfrancia.txt"
BTW = "countries/Batalyaws.txt"
MFC = "countries/Middlefrancia.txt"
CAP = "countries/Capua.txt"
BNV = "countries/Benevento.txt"
API = "countries/Apulia.txt"
SLR = "countries/Salerno.txt"
TRC = "countries/Trinacria.txt"
NSE = "countries/Northsea.txt"
UNN = "countries/Unetherlands.txt"
ABS = "countries/Abbasids.txt"
GLL = "countries/Gallia.txt"
UNP = "countries/Unitedp.txt"
SLC = "countries/Carantania.txt"
BLT = "countries/Baltic.txt"
WEE = "countries/Wendish.txt"
WRE = "countries/Westrome.txt"
WSX = "countries/Wessex.txt"
SSX = "countries/Sussex.txt"
MRC = "countries/Mercia.txt"
KNT = "countries/Kent.txt"
ESX = "countries/Essex.txt"
SLL = "countries/Sale.txt"
ILR = "countries/Illyria.txt"
TKL = "countries/Tecklenburg.txt"
RVB = "countries/Ravensberg.txt"
HYA = "countries/Hoya.txt"
HAS = "countries/Hanseatic.txt"
MKG = "countries/Mark.txt"
DRE = "countries/Dresden.txt"
EAN = "countries/Eastanglia.txt"
MAC = "countries/Macedonia.txt"
LAT = "countries/Latinempire.txt"
NRD = "countries/Nordmark.txt"
TCL = "countries/Caliphate.txt"
FRC = "countries/Francia.txt"
LWB = "countries/Lowerburgundy.txt"
UPB = "countries/Upperburgundy.txt"
FRK = "countries/Frankishempire.txt"
ARS = "countries/Arles.txt"
SLV = "countries/Carniola.txt"
PNN = "countries/Pannonia.txt"
MGY = "countries/Magyars.txt"
BCS = "countries/Bacs.txt"
UNG = "countries/Ung.txt"
SZK = "countries/Szekely.txt"
NAZ = "countries/Nizzarids.txt"
ATI = "countries/Antioch.txt"
LOM = "countries/Lombardy.txt"
ITL = "countries/Italiyya.txt"
TST = "countries/Trieste.txt"
OTR = "countries/Outremer.txt"
VIS = "countries/Vistulans.txt"
LUD = "countries/Lendians.txt"
PLN = "countries/Polans.txt"
VLT = "countries/Veleti.txt"
OBD = "countries/Obotrites.txt"
PRR = "countries/Pruthenia.txt"
WRT = "countries/WhiteRuthenia.txt"
NCI = "countries/Nicaea.txt"
VLD = "countries/Vladimir.txt"
CLT = "countries/Celtic.txt"
PDL = "countries/Podolia.txt"
VLG = "countries/Vologda.txt"
IBE = "countries/Iberia.txt"
SMG = "countries/Samogitia.txt"
CBR = "countries/Carribean.txt"
CBN = "countries/Ciboney.txt"
GRF = "countries/Garifuna.txt"
TII = "countries/Taino.txt"
CLE = "countries/Celestialempire.txt"
VI1 = "countries/Danvinland.txt"
VI2 = "countries/Norvinland.txt"
FR1 = "countries/Carolingie.txt"
FR2 = "countries/Acadia.txt"
FR3 = "countries/Antilles.txt"
FR4 = "countries/Nouvellefrancie.txt"
FR5 = "countries/Mexique.txt"
FR6 = "countries/Guyane.txt"
FR7 = "countries/Perou.txt"
FR8 = "countries/Australe.txt"
FR9 = "countries/Largent.txt"
FRL = "countries/Kalifornia.txt"
FRX = "countries/Antartique.txt"
FRW = "countries/Cascadia.txt"
AD1 = "countries/Brasiliyya.txt"
AD2 = "countries/Qulumbia.txt"
AD3 = "countries/Alantil.txt"
AD4 = "countries/Alandiz.txt"
AD5 = "countries/Amriqa.txt"
AD6 = "countries/Dhahabi.txt"
AD7 = "countries/Anjar.txt"
AD8 = "countries/Kalifurnya.txt"
AD9 = "countries/Adualaska.txt"
A10 = "countries/Mashiyyka.txt"
A11 = "countries/Usturiyya.txt"
A12 = "countries/Alabradur.txt"
EN1 = "countries/Niwewesteaxe.txt"
EN2 = "countries/Niweafundeland.txt"
EN3 = "countries/Westindea.txt"
EN4 = "countries/Feorland.txt"
EN5 = "countries/Enmexico.txt"
EN6 = "countries/Guyana.txt"
EN7 = "countries/Enperu.txt"
EN8 = "countries/Niwenorth.txt"
EN9 = "countries/Niweengland.txt"
ENR = "countries/Niwesuth.txt"
ENQ = "countries/Folkland.txt"
ENW = "countries/Enkalifornia.txt"
HTM = "countries/Hetmanate.txt"
NS1 = "countries/Nvinland.txt"
NS2 = "countries/Nsaerland.txt"
NS3 = "countries/Nstrondland.txt"
NS4 = "countries/Nskogrland.txt"
NS5 = "countries/Nmithaland.txt"
NS6 = "countries/Njormungandria.txt"
NS7 = "countries/Ngulland.txt"
NS8 = "countries/Nleifland.txt"
NS9 = "countries/Nygdrasiland.txt"
N10 = "countries/Nsilfrland.txt"
N11 = "countries/Naudrland.txt"
N12 = "countries/Nsudriland.txt"
IR1 = "countries/Ireland1.txt"
IR2 = "countries/Ireland2.txt"
IR3 = "countries/Ireland3.txt"
IR4 = "countries/Ireland4.txt"
IR5 = "countries/Ireland5.txt"
IR6 = "countries/Ireland6.txt"
IR7 = "countries/Ireland7.txt"
IR8 = "countries/Ireland8.txt"
IR9 = "countries/Ireland9.txt"
IRV = "countries/Ireland10.txt"
IRW = "countries/Ireland11.txt"
IRX = "countries/Ireland12.txt"
FN1 = "countries/Finngail1.txt"
FN2 = "countries/Finngail2.txt"
FN3 = "countries/Finngail3.txt"
FN4 = "countries/Finngail4.txt"
FN5 = "countries/Finngail5.txt"
FN6 = "countries/Finngail6.txt"
FN7 = "countries/Finngail7.txt"
FN8 = "countries/Finngail8.txt"
FN9 = "countries/Finngail9.txt"
FNQ = "countries/Finngail10.txt"
FNW = "countries/Finngail11.txt"
FNX = "countries/Finngail12.txt"
DL1 = "countries/Dualmonarchy1.txt"
DL2 = "countries/Dualmonarchy2.txt"
DL3 = "countries/Dualmonarchy3.txt"
DL4 = "countries/Dualmonarchy4.txt"
DL5 = "countries/Dualmonarchy5.txt"
DL6 = "countries/Dualmonarchy6.txt"
DL7 = "countries/Dualmonarchy7.txt"
DL8 = "countries/Dualmonarchy8.txt"
DL9 = "countries/Dualmonarchy9.txt"
DLQ = "countries/Dualmonarchy10.txt"
DLW = "countries/Dualmonarchy11.txt"
DLX = "countries/Dualmonarchy12.txt"